16 14 16 16
0 1 2 3 2 3 2 8 9 5 4 5 4 5 6 7 
12 13 14 15 14 15 14 20 21 17 16 17 16 17 18 19 
24 25 27 27 27 27 27 27 27 27 27 27 27 27 30 31 
36 37 27 28 26 26 26 27 27 26 26 26 28 27 42 43 
24 25 27 26 28 27 27 27 27 27 27 28 26 27 30 31 
36 37 27 26 27 39 27 27 27 27 40 27 26 27 42 43 
24 25 27 27 27 27 27 27 27 27 27 27 27 27 34 35 
36 37 27 27 27 27 27 27 27 27 27 27 27 27 46 47 
48 49 27 26 27 39 27 27 27 27 40 27 26 27 54 55 
60 61 27 26 28 27 27 27 27 27 27 28 26 27 66 67 
48 49 27 28 26 26 26 27 27 26 26 26 28 27 54 55 
60 61 27 27 27 27 27 27 27 27 27 27 27 27 66 67 
72 73 74 75 74 75 74 10 11 77 76 77 76 77 78 79 
84 85 86 87 86 87 86 22 23 89 88 89 88 89 90 91 

1 1 1 1 1 1 1 0 0 1 1 1 1 1 1 1 
1 1 1 1 1 1 1 0 0 1 1 1 1 1 1 1 
1 1 0 0 0 0 0 0 0 0 0 0 0 0 1 1 
1 1 0 2 0 0 0 0 0 0 0 0 2 0 1 1 
1 1 0 0 2 0 0 0 0 0 0 2 0 0 1 1 
1 1 0 0 0 2 0 0 0 0 2 0 0 0 1 1 
1 1 0 0 0 0 0 0 0 0 0 0 0 0 0 0 
1 1 0 0 0 0 0 0 0 0 0 0 0 0 0 0 
1 1 0 0 0 2 0 0 0 0 2 0 0 0 1 1 
1 1 0 0 2 0 0 0 0 0 0 2 0 0 1 1 
1 1 0 2 0 0 0 0 0 0 0 0 2 0 1 1 
1 1 0 0 0 0 0 0 0 0 0 0 0 0 1 1 
1 1 1 1 1 1 1 0 0 1 1 1 1 1 1 1 
1 1 1 1 1 1 1 0 0 1 1 1 1 1 1 1 

